111111111111111111111111111110000011111111111111111111111111111
111111111111111111111111111110000011111111111111111111111111111
111111111111111111111111111110000011111111111111111111111111111
110110111111111111100110011110000011110011011000111000110110011
110000011111111111000000011110000011110000000000000000000000001
110000000000000000000000000010000000000000000000000000000000011
000000000000000000000000000000000000000000000000000000000000000
111000000000000000000001111000000000111100000000000000000000000
111000000111111111110111111000000000111100000000000000000000000
111000000111111111110111111000000000111100000000000000000000011
111000000111111111110111111110000011111111111111111110000000111
111110111111111000000011111110000011111111111111111110000001111
111110111111111000000011111110000011111111111111111110000011111
111110111111111111000011111110000011111111111111111110000111111
111000000011111111111111111110000000001111111000000000000111111
111000000011111111111111111110000000001111111000000000000111111
111000000001111111111111111110000000000111110000000000000111111
111000000001111111111111110000000000000111100000000000000111111
111000000001111111111111110000000000000111100000000000000111111
111000000001111111111111110000000000000111100000000000000111111
111000000001111111111111100000000011111111111111000000000111111
111000000001111111111111100000000011111111111111000000000111111
111000000001111111111111100000000011111111111111000000000111111
111000000011111111100000000000000011111111111111000000000111111
111111110111111111100000000000000011111111111111000000000001011
111111111111111111100000000000000011100000000011000000000000011
111111111111111111100000000000000010000000000011000000000000011
111111111111111111100000000000000010000000000011000000000000011
111111111111111111111100000000000010000100100011111100000000001
110000001111111000111100000000000010000100111111111100000000001
110000001111111110111100000000000011111100111111111100000000001
110111111111111110111111111100000011111100111111111100001111011
110111111111111110111111111100000000000000001111111000001111011
110111111111111110111111111100000000000000001111111000001111011
110111111111111110111111111110000000000000001111111000001111111
110000001111111110000000011110000000000000000000000000000000111
110000011111111111000000011110000000000000000000000000000000111
110000000000000000000000011110000000000000011111111110000000011
110000000000000000000000000000000000000000011111111110000000011
110000000000000000000000000000000000000000011111111110000000011
111111111111111111111111111111111111111111111111111111111111111
111111111111111111111111111111111111111111111111111111111111111
111111111111111111111111111111111111111111111111111111111111111
